1111111111
1000000001
10P0000001
1000000001
1111011111
100P000001
10000P1101
100100P001
1000000011
1111111111

