11111111111111111111
10000000000000000001
100P0000000001000001
10000000000001000001
10000000000001000001
10001111000001000001
10001111000000000001
10001111000000000001
10000000000000000001
10000000001111100001
10000000000000000001
10000000000000000001
11110000000000000001
10000000000011111111
10000000000000000001
10000000000000000001
10000000000000000001
10000000000000000001
10000000000000000001
11111111111111111111
